###########
#     #  ##
@ #      ##
# #      ##
# ###    ##
#        ##
######   ##
#      # ##
#        %#
###########