##########
#     #  #
@ #      #
# #      #
# ###    #
#        #
######   #
#      # #
#        %
##########